54 340
1
1 1 0 -8445952 1 1 3 1
2 1 0 -8445952 1 1 3 1
3 1 0 -8445952 1 1 3 1
4 1 0 -8445952 1 1 3 1
5 1 0 -8445952 1 1 3 1
6 1 0 -8445952 1 1 3 1
7 1 0 -8445952 1 1 3 1
8 1 0 -8445952 1 1 3 1
9 1 0 -8445952 1 1 3 1
10 1 0 -8445952 1 1 3 1
11 1 0 -8445952 1 1 3 1
12 1 0 -8445952 1 1 3 1
13 1 0 -8445952 1 1 3 1
14 1 0 -8445952 1 1 3 1
15 1 0 -8445952 1 1 3 1
16 1 0 -8445952 1 1 3 1
17 1 0 -8445952 1 1 3 1
18 1 0 -8445952 1 1 3 1
19 1 0 -8445952 1 1 3 1
20 1 0 -8445952 1 1 3 1
21 1 0 -8445952 1 1 3 1
22 1 0 -8445952 1 1 3 1
23 1 0 -8445952 1 1 3 1
24 1 0 -8445952 1 1 3 1
25 1 0 -8445952 1 1 3 1
26 1 0 -8445952 1 1 3 1
27 1 0 -8445952 1 1 3 1
28 1 0 -8445952 1 1 3 1
29 1 0 -8445952 1 1 3 1
30 1 0 -8445952 1 1 3 1
31 1 0 -8445952 1 1 3 1
32 1 0 -8445952 1 1 3 1
33 1 0 -8445952 1 1 3 1
34 1 0 -8445952 1 1 3 1
35 1 0 -8445952 1 1 3 1
36 1 0 -8445952 1 1 3 1
37 1 0 -8445952 1 1 3 1
38 1 0 -8445952 1 1 3 1
39 1 0 -8445952 1 1 3 1
40 1 0 -8445952 1 1 3 1
41 1 0 -8445952 1 1 3 1
42 1 0 -8445952 1 1 3 1
43 1 0 -8445952 1 1 3 1
44 1 0 -8445952 1 1 3 1
45 1 0 -8445952 1 1 3 1
46 1 0 -8445952 1 1 3 1
47 1 0 -8445952 1 1 3 1
48 1 0 -8445952 1 1 3 1
49 1 0 -8445952 1 1 3 1
50 1 0 -8445952 1 1 3 1
51 1 0 -8445952 1 1 3 1
52 1 0 -8445952 1 1 3 1
53 1 0 -8445952 1 1 3 1
41 2 0 -8445952 1 1 3 1
42 2 0 -8445952 1 1 3 1
43 2 0 -8445952 1 1 3 1
44 2 0 -8445952 1 1 3 1
45 2 0 -8445952 1 1 3 1
46 2 0 -8445952 1 1 3 1
47 2 0 -8445952 1 1 3 1
48 2 0 -8445952 1 1 3 1
49 2 0 -8445952 1 1 3 1
1 3 0 -5592406 3 1
3 5 0 -15724528 3 1
13 5 0 -1 3 1
21 5 0 -1 3 1
10 6 0 -16777216 4 1
29 6 0 -1 3 1
19 7 0 -1 3 1
17 8 0 -1 3 1
4 9 0 -1 3 1
12 10 0 -1 3 1
2 11 0 -1 3 1
12 12 0 -1 3 1
34 12 0 -1 3 1
17 13 0 -1 3 1
7 14 0 -1 3 1
24 14 0 -1 3 1
12 17 0 -1 3 1
17 18 0 -1 3 1
24 18 0 -1 3 1
9 20 0 -1 3 1
17 20 0 -1 3 1
5 21 0 -1 3 1
20 24 0 -1 3 1
29 24 0 -1 3 1
13 26 0 -1 3 1
3 27 0 -1 3 1
10 28 0 -1 3 1
22 32 0 -1 3 1
11 33 0 -1 3 1