15 110
1
2 3 0 -16711936 1 1 3 1
3 3 0 -16711936 1 1 3 1
4 3 0 -16711936 1 1 3 1
5 3 0 -16711936 1 1 3 1
6 3 0 -16711936 1 1 3 1
7 3 0 -16711936 1 1 3 1
8 3 0 -16711936 1 1 3 1
9 3 0 -16711936 1 1 3 1
10 3 0 -16711936 1 1 3 1
11 3 0 -16711936 1 1 3 1
12 3 0 -16711936 1 1 3 1
13 3 0 -16711936 1 1 3 1
14 3 0 -16711936 1 1 3 1
1 4 0 -16711936 1 1 3 1
2 4 0 -16711936 1 1 3 1
1 5 0 -16711936 1 1 3 1
1 6 0 -16711936 1 1 3 1
5 6 0 -16777216 4 1
1 7 0 -16711936 1 1 3 1
1 8 0 -16711936 1 1 3 1
5 8 0 -16738048 2 2
7 8 0 -6750208 2 0
8 8 0 -6750208 2 0
1 9 0 -16711936 1 1 3 1
1 10 0 -16711936 1 1 3 1